30 27
╔═════╦═════════════╦═════╦═══════╦═╦═════╦═══════════╗
║     ║             ║     ║       ║ ║     ║           ║
║ ╔═╗ ║ ══╦═══╗ ║ ══╝ ║ ║ ╚══ ╔═╗ ║ ║ ║ ║ ║ ════════╗ ║
║ ║ ║ ║   ║   ║ ║     ║ ║     ║ ║ ║   ║ ║ ║         ║ ║
║ ║ ║ ╠══ ║ ║ ╠═╩═════╝ ╠═════╣ ║ ║ ╔═╝ ║ ╚═════╦═══╣ ║
║ ║   ║   ║ ║ ║         ║     ║   ║ ║   ║       ║   ║  
║ ║ ══╩═╦═╝ ║ ║ ╔═══════╬════ ║ ══╣ ║ ╔═╩═════╗ ║ ║ ║ ║
║ ║     ║   ║ ║ ║       ║     ║   ║ ║ ║       ║ ║ ║ ║ ║
║ ╚═╦═╗ ║ ╔═╣ ║ ╠══ ╔══ ║ ╔═══╩═╗ ║ ║ ║ ══╦═══╣ ║ ║ ║ ║
║   ║ ║   ║ ║ ║ ║   ║     ║     ║ ║ ║ ║   ║   ║   ║ ║ ║
╠══ ║ ╚═══╝ ║ ║ ║ ══╩═════╝ ══╗ ║ ╚═╣ ╚═╗ ║ ║ ╠═══╝ ║ ║
║   ║         ║ ║             ║     ║   ║   ║ ║     ║ ║
║ ══╣ ════════╣ ╚═══╦═══════╗ ╠═══╗ ║ ║ ╚═╗ ║ ║ ╔═══╝ ║
║   ║         ║     ║       ║ ║   ║ ║ ║   ║ ║   ║     ║
║ ║ ╚═══════╗ ╚════ ║ ══╦═╗ ╚═╝ ║ ║ ╚═╩══ ║ ╚═╦═╩════ ║
║ ║         ║       ║   ║ ║     ║ ║       ║   ║       ║
║ ╠═════╦═╗ ╚═══╦═══╩═╗ ║ ╚═╦═══╣ ║ ╔═══╦═╬══ ║ ══╦══ ║
║ ║     ║ ║     ║     ║ ║   ║   ║ ║ ║   ║ ║   ║   ║   ║
║ ║ ╔═╗ ║ ╠═══╗ ║ ║ ══╣ ║ ║ ║ ║ ║ ╠═╝ ║ ║ ║ ╔═╝ ║ ║ ══╣
║   ║ ║   ║   ║   ║   ║ ║ ║ ║ ║ ║ ║   ║ ║   ║   ║ ║   ║
╠═╦═╝ ╠══ ║ ══╩═╦═╩═╗ ║ ║ ║ ║ ║ ║ ║ ══╣ ╚═╗ ╚═══╝ ╠══ ║
║ ║   ║   ║     ║   ║ ║ ║ ║   ║ ║     ║   ║       ║   ║
║ ║ ║ ║ ══╩═╗ ║ ╠══ ║ ║ ║ ╠═══╝ ╠═══╦═╩══ ╠═════╦═╝ ══╣
║   ║ ║     ║ ║ ║   ║ ║ ║ ║     ║   ║     ║     ║     ║
║ ══╣ ╚═══╗ ║ ║ ║ ╔═╝ ║ ║ ║ ════╝ ║ ║ ══╦═╝ ══╗ ╠═══╗ ║
║   ║     ║ ║ ║ ║ ║   ║ ║ ║       ║ ║   ║     ║ ║   ║ ║
╠══ ║ ════╝ ║ ║ ║ ║ ║ ║ ║ ╠════ ╔═╩═╬══ ║ ══╦═╝ ║ ║ ║ ║
║   ║       ║ ║   ║ ║ ║   ║     ║   ║   ║   ║   ║ ║ ║ ║
║ ══╬═══════╝ ╠══ ║ ╚═╬═══╣ ══╦═╝ ║ ║ ║ ╠══ ║ ══╝ ║ ╚═╣
║   ║         ║   ║   ║   ║   ║   ║   ║ ║   ║     ║   ║
╠══ ╚═══╗ ══╦═╩═══╩══ ║ ║ ╚═╗ ║ ══╩═╦═╣ ║ ╔═╩═╦═╦═╩═╗ ║
║       ║   ║         ║ ║   ║ ║     ║ ║ ║ ║   ║ ║   ║ ║
╠═════╗ ╚══ ║ ══════╦═╝ ╠═╗ ║ ╠════ ║ ║ ║ ║ ║ ║ ║ ║ ║ ║
║     ║     ║       ║   ║ ║   ║     ║ ║ ║ ║ ║ ║   ║ ║ ║
║ ╔══ ╠═══╗ ╠══════ ║ ══╣ ╚═══╣ ══╦═╣ ║ ║ ║ ║ ╠═══╝ ║ ║
  ║   ║   ║ ║       ║   ║     ║   ║ ║   ║   ║ ║     ║ ║
╔═╣ ╔═╝ ║ ║ ║ ╔═╦══ ╚═╗ ║ ╔═══╩═╗ ║ ║ ╔═╩═══╣ ║ ╔═══╝ ║
║ ║ ║   ║   ║ ║ ║     ║   ║     ║ ║   ║     ║ ║ ║     ║
║ ║ ║ ══╩═╦═╝ ║ ║ ══╦═╩══ ║ ╔═╗ ║ ╚═╗ ║ ══╗ ║ ║ ║ ╔══ ║
║ ║ ║     ║   ║     ║     ║ ║ ║ ║   ║ ║   ║     ║ ║   ║
║ ║ ╠═══╦═╝ ╔═╩═══╗ ║ ╔═══╝ ║ ║ ╚══ ║ ╠═╗ ╠═╦═══╝ ║ ╔═╣
║   ║   ║   ║     ║ ║ ║     ║       ║ ║ ║ ║ ║     ║ ║ ║
║ ══╝ ║ ║ ══╝ ╔═╗ ║ ║ ║ ╔═══╩═╦═══╦═╝ ║ ║ ║ ║ ╔═══╝ ║ ║
║     ║ ║     ║ ║ ║ ║ ║ ║     ║   ║     ║   ║ ║       ║
╠═══╦═╝ ║ ════╝ ║ ╚═╝ ║ ║ ╔═╗ ║ ║ ╚═════╩══ ║ ╚═══════╣
║   ║   ║       ║     ║ ║ ║ ║   ║           ║         ║
║ ══╝ ╔═╩═╦════ ╠═════╣ ║ ║ ╚═══╬═════════╗ ╚═══╦═══╗ ║
║     ║   ║     ║     ║ ║       ║         ║     ║   ║ ║
║ ╔═══╣ ║ ║ ══╦═╝ ╔═╗ ║ ╚═══╦══ ║ ══╦═══╗ ╚═══╦═╝ ║ ║ ║
║ ║   ║ ║ ║   ║   ║ ║ ║     ║   ║   ║   ║     ║   ║ ║ ║
║ ║ ║ ║ ║ ╠══ ║ ╔═╝ ║ ╚═══╗ ║ ══╩═╗ ║ ║ ╚═══╗ ║ ╔═╝ ║ ║
║   ║   ║ ║   ║ ║   ║     ║       ║ ║ ║     ║   ║   ║ ║
╠═╦═╩═══╣ ╚═╦═╝ ║ ══╩═╦══ ║ ╔═════╝ ╠═╝ ╔═╗ ╠═══╝ ╔═╝ ║
║ ║     ║   ║   ║     ║   ║ ║       ║   ║ ║ ║     ║   ║
║ ║ ║ ╔═╩═╗ ║ ══╩═╗ ══╝ ╔═╝ ║ ══════╣ ╔═╝ ║ ║ ╔═══╝ ══╣
║ ║ ║ ║   ║ ║     ║     ║   ║       ║ ║     ║ ║       ║
║ ║ ║ ║ ║ ║ ╚═╗ ║ ║ ══╦═╝ ╔═╩═╗ ╔══ ║ ║ ╔═══╝ ╠═════╗ ║
║ ║ ║   ║ ║   ║ ║ ║   ║   ║   ║ ║   ║ ║ ║     ║     ║ ║
║ ║ ╚═══╣ ╚══ ╚═╝ ╠══ ╚═══╝ ║ ╚═╝ ╔═╝ ╚═╝ ════╝ ╔══ ║ ║
║       ║         ║         ║     ║             ║     ║
╚═══════╩═════════╩═════════╩═════╩═════════════╩═════╝

