28 30
╔═══════════════╦═════╦═══╦═════╦═════════╦═══╦═══╦═════════╗
║               ║     ║   ║     ║         ║   ║   ║         ║
║ ╔═══╗ ╔═══╦══ ╠══ ║ ║ ║ ║ ╔═╗ ╚═╗ ║ ════╝ ║ ║ ║ ║ ╔═╦════ ║
║ ║   ║ ║   ║   ║   ║   ║   ║ ║   ║ ║       ║   ║ ║ ║ ║     ║
║ ╚══ ║ ║ ══╝ ══╝ ╔═╬═══╩═══╝ ╚═╗ ╚═╩═══╗ ══╩═╦═╝ ║ ║ ║ ════╣
║     ║ ║         ║ ║           ║       ║     ║   ║   ║     ║
╠═══╗ ║ ╚═══╦═════╣ ║ ║ ══╦═════╩═════╗ ║ ╔═══╝ ╔═╩══ ╠════ ║
║   ║ ║     ║     ║   ║   ║           ║ ║ ║     ║     ║      
║ ║ ║ ╠════ ║ ║ ╔═╝ ╔═╩═╗ ║ ════╗ ════╝ ║ ║ ════╣ ╔═══╣ ╔══ ║
║ ║   ║     ║ ║ ║   ║   ║ ║     ║       ║ ║     ║ ║   ║ ║   ║
╠═╩═╦═╝ ╔═══╩═╣ ║ ╔═╝ ║ ║ ╠═══╗ ╠═══╦═══╣ ╚═╦═╗ ║ ║ ║ ║ ║ ══╣
║   ║   ║     ║   ║   ║   ║   ║ ║   ║   ║   ║ ║   ║ ║ ║ ║   ║
║ ║ ║ ╔═╩══ ║ ╚═══╝ ╔═╩══ ║ ║ ║ ╚═╗ ║ ║ ╚═╗ ║ ╚═╦═╝ ║ ║ ╠═╗ ║
║ ║   ║     ║       ║     ║ ║ ║   ║   ║   ║ ║   ║   ║ ║ ║ ║ ║
║ ╠═╦═╝ ════╣ ╔═════╣ ════╩═╝ ╚═╗ ╚═══╩═╗ ║ ╚══ ║ ╔═╝ ║ ║ ║ ║
║ ║ ║       ║ ║     ║           ║       ║ ║     ║ ║     ║   ║
║ ║ ║ ╔═══╗ ╚═╝ ╔═╗ ╚═╦═════╦══ ╠═════╗ ║ ╚═╦═╗ ║ ╚═════╩═══╣
║ ║ ║ ║   ║     ║ ║   ║     ║   ║     ║ ║   ║ ║ ║           ║
║ ║ ║ ║ ══╩═════╣ ╚═╗ ╚═══╗ ║ ╔═╩═══╗ ║ ║ ║ ║ ║ ╚═════╦════ ║
║ ║ ║ ║         ║   ║     ║   ║     ║ ║ ║ ║   ║       ║     ║
║ ║ ║ ╠══ ╔═╦══ ║ ══╬═══╗ ║ ══╣ ══╗ ║ ║ ║ ╠═══╩══ ╔═══╣ ══╗ ║
║ ║   ║   ║ ║   ║   ║   ║ ║   ║   ║   ║ ║ ║       ║   ║   ║ ║
║ ╚═╗ ║ ╔═╝ ║ ══╩═╗ ║ ║ ║ ╠═╗ ╚═╗ ║ ╔═╝ ║ ║ ╔═══╦═╝ ║ ║ ║ ║ ║
║   ║   ║   ║     ║ ║ ║   ║ ║   ║ ║ ║   ║   ║   ║   ║ ║ ║ ║ ║
║ ║ ╚═╦═╝ ║ ╚════ ║ ║ ╠═══╝ ╚═╗ ║ ╚═╣ ╔═╣ ══╣ ║ ║ ══╣ ║ ║ ╚═╣
║ ║   ║   ║         ║ ║       ║ ║   ║ ║ ║   ║ ║ ║   ║ ║ ║   ║
║ ╠══ ║ ══╩═╦═════╦═╝ ╠═══╗ ║ ║ ╚═╗ ║ ║ ╚══ ║ ║ ╠═╗ ║ ╚═╩═╗ ║
║ ║   ║     ║     ║   ║   ║ ║ ║   ║ ║ ║       ║ ║ ║ ║     ║ ║
╚═╝ ╔═╩═╗ ╔═╝ ╔══ ║ ╔═╝ ║ ╚═╝ ╚═╗ ║ ║ ╚═══╦═══╣ ║ ║ ╚═╦═╗ ║ ║
    ║   ║ ║   ║   ║ ║   ║       ║ ║ ║     ║   ║   ║   ║ ║   ║
╔═══╩══ ║ ║ ╔═╝ ╔═╝ ║ ║ ╠═══╦═══╣ ║ ╠════ ║ ║ ╚═══╩═╗ ║ ╚═╗ ║
║       ║ ║ ║   ║   ║ ║ ║   ║   ║ ║ ║     ║ ║       ║ ║   ║ ║
║ ══════╝ ║ ╚═╗ ║ ╔═╣ ║ ║ ║ ║ ║ ║ ║ ║ ╔═══╝ ╠═════╗ ║ ║ ║ ║ ║
║         ║   ║   ║ ║ ║   ║   ║ ║   ║ ║     ║     ║ ║ ║ ║ ║ ║
╠═══╗ ══╦═╩═╗ ╠═══╣ ║ ╚═╦═╩═══╣ ╚═╗ ║ ║ ║ ══╣ ══╗ ║ ║ ║ ╠═╝ ║
║   ║   ║   ║ ║   ║ ║   ║     ║   ║ ║ ║ ║   ║   ║ ║   ║ ║   ║
║ ║ ╠══ ╚═╗ ║ ║ ║ ║ ╚═╗ ║ ╔══ ║ ║ ║ ║ ╚═╬══ ╠═══╣ ╚═══╝ ║ ╔═╣
║ ║ ║     ║ ║   ║ ║   ║   ║   ║ ║ ║ ║   ║   ║   ║       ║ ║ ║
║ ║ ╚═╦═╗ ║ ╚═══╣ ║ ══╩═══╝ ╔═╣ ╚═╝ ╠══ ║ ╔═╝ ║ ║ ════╗ ║ ║ ║
║ ║   ║ ║ ║     ║ ║         ║ ║     ║   ║ ║   ║ ║     ║   ║ ║
║ ╠══ ║ ║ ╚════ ║ ╚═╗ ══╦═══╣ ╚═╦═══╝ ╔═╝ ║ ╔═╝ ╠═╦══ ╠═══╝ ║
║ ║   ║ ║       ║   ║   ║   ║   ║     ║     ║   ║ ║   ║     ║
║ ║ ══╣ ╚═╦══ ╔═╩══ ╠══ ║ ║ ╚══ ║ ════╩═════╝ ╔═╣ ║ ╔═╝ ════╣
║ ║   ║   ║   ║     ║   ║ ║     ║             ║ ║   ║       ║
║ ╚═╗ ║ ║ ║ ╔═╝ ╔═══╝ ╔═╝ ╠════ ╚═════╦═══════╝ ║ ══╣ ══╦══ ║
║   ║ ║ ║   ║   ║     ║   ║           ║         ║   ║   ║   ║
║ ║ ║ ╚═╩═══╣ ══╬═══╗ ║ ══╩═╦═════════╣ ║ ╔══ ╔═╩══ ╠═══╣ ║ ║
║ ║ ║       ║   ║   ║ ║     ║         ║ ║ ║   ║     ║   ║ ║ ║
║ ║ ╠═════╗ ╚═╗ ║ ║ ║ ║ ══╗ ║ ╔═╦═══╗ ║ ║ ╚═╗ ║ ╔═══╝ ║ ║ ║ ║
║ ║ ║     ║   ║   ║ ║ ║   ║ ║ ║ ║   ║   ║   ║ ║ ║     ║   ║ ║
║ ║ ║ ══╗ ╠══ ╚═╦═╝ ║ ╚═══╝ ║ ║ ║ ║ ╚═══╬═╗ ╠═╝ ║ ╔═══╩═══╣ ║
║ ║ ║   ║ ║     ║   ║       ║ ║ ║ ║     ║ ║ ║   ║ ║       ║ ║
║ ║ ╚═╗ ║ ╠═══╗ ║ ╔═╩═════╦═╝ ║ ║ ╚═╗ ║ ║ ║ ║ ══╝ ║ ║ ══╦═╝ ║
║ ║   ║ ║ ║   ║   ║       ║   ║     ║ ║   ║ ║     ║ ║   ║   ║
║ ║ ══╝ ║ ║ ║ ╚═══╝ ════╗ ║ ══╩═════╝ ╠══ ║ ╚═════╝ ╚═╗ ║ ══╣
║ ║     ║   ║           ║             ║   ║           ║     ║
╚═╩═════╩═══╩═══════════╩═════════════╩═══╩═══════════╩═════╝

